11111111111111
12222222222222
12111111111211
12111111111211
12222221122211
11121121121111
11121121121111
13221122222224
12111121111121
12111121111121
12222222222221
11111121101111
11111121101111
11111121100000
11111121101110
11111121101110
00000021101505
